NO ./assets/north.xpm
EA ./assets/east.xpm
C 225,30,1
WE ./assets/west.xpm
F 225,30,1
SO   ./assets/south.xpm

        111111111111111111111111
        100000000110000000000001
        1011000001110000000000001
        1001000000000000000000001
111111111011000001110000000000001
100000000011000001110111111111111
11110111111111011100000010001
11110111111111011101010010001
11000000110101011100000010001
10000000000000001100000010001
10000000000000001101010010001
11000001110101011111011110011
1110111 1110101 101111010N001
11111111 1111111 111111111111